Artist	Album	Name	Track Number18 Candles	The Sessions Is Listed As In a Relationship	3	18 Candles
1940 (AmpLive Remix)	Honeysuckle Remixes	1	1940 (AmpLive Remix)
A Complicated Song (Parody of "Complicated" by Avril Lavigne)	Poodle Hat	7	A Complicated Song (Parody of "Complicated" by Avril Lavigne)
Afterglow	Hold Fast	1	Afterglow
All That She Wants	Ace of Base: Greatest Hits	3	All That She Wants
Atlantis	Miracle Mile	10	Atlantis
Bottle Up And Explode!	XO	11	Bottle Up And Explode!
Change of Heart	Picture You Staring	9	Change of Heart
Crystalised	xx (Bonus Track Version)	3	Crystalised
Da Funk (Album Version)	Da Funk	1	Da Funk (Album Version)
Dark Arts (Radio Mix)	Dark Arts (Deluxe Edition) [Remixes]	1	Dark Arts (Radio Mix)
Don't Turn Around	Ace of Base: Greatest Hits	9	Don't Turn Around
Dream Weaver	No Man's Land	3	Dream Weaver
Ebay (Parody of "I Want It That Way" by the Backstreet Boys)	Poodle Hat	11	Ebay (Parody of "I Want It That Way" by the Backstreet Boys)
Florida	Starfucker	1	Florida
German Love	Starfucker	2	German Love
Giants	Curiosity	4	Giants
In Search Of	Miike Snow (Deluxe Edition)	10	In Search Of
Intro	xx (Bonus Track Version)	1	Intro
Islands	xx (Bonus Track Version)	4	Islands
Let the Drummer Kick	Citizen Cope	4	Let the Drummer Kick
Life In the Rain	The 5th Exotic	5	Life In the Rain
Microlite	Microlite - Single	1	Microlite
Midnight City	Hurry Up, We're Dreaming.	2	Midnight City
Op. 64: Romeo & Juliet - 0. Introduction	Prokofiev: Romeo and Juliet;Maazel	1	Op. 64: Romeo & Juliet - 0. Introduction
Other Side	No Man's Land	14	Other Side
Prokofiev: Romeo & Juliet - Dance Of The Knights	Prokofiev: Romeo and Juliet;Maazel	11	Prokofiev: Romeo & Juliet - Dance Of The Knights
Purple Yellow Red and Blue	Evil Friends	11	Purple Yellow Red and Blue
Radioactive	Night Visions	1	Radioactive
Rapper's Delight	The Best Of The Sugar Hill Gang	1	Rapper's Delight
Rawnald Gregory Erickson the Second	Starfucker	5	Rawnald Gregory Erickson the Second
Rings of Saturn	Tender Opposites	8	Rings of Saturn
Shining Down (feat. Matthew Santos) [Bonus Track]	Lasers (Deluxe Version)	14	Shining Down (feat. Matthew Santos) [Bonus Track]
Sirens (Extended Version)	Sirens - EP	5	Sirens (Extended Version)
Spirit Forest	Curiosity	3	Spirit Forest
St. Ides Heaven	Elliott Smith	9	St. Ides Heaven
Stadium Love	Fantasies	10	Stadium Love
Strobe (Club Edit)	Strobe	2	Strobe (Club Edit)
Summer Reign	Summer Reign - Single	1	Summer Reign
Sweet Adeline	XO	1	Sweet Adeline
Symphonies	Un	1	Symphonies
The Amazing Heart Attack	Bazaar	1	The Amazing Heart Attack
The Fear of Charlie Sunrise	Baby Monster	1	The Fear of Charlie Sunrise
The Glass Traditions	Mystery Pills - EP	1	The Glass Traditions
The Hearse	Curiosity	1	The Hearse
The Saltwater Room	Ocean Eyes	5	The Saltwater Room
The Sign	Ace of Base: Greatest Hits	2	The Sign
Walking On a Dream	Walking On a Dream	2	Walking On a Dream
Way to be Loved	Picture You Staring	1	Way to be Loved
Weird Fishes / Arpeggi	In Rainbows	4	Weird Fishes / Arpeggi
What's Going On	Stacked Up	5	What's Going On
White & Nerdy (Parody of "Ridin'")	Straight Outta Lynwood	1	White & Nerdy (Parody of "Ridin'")
Wolf Like Me	Return to Cookie Mountain	5	Wolf Like Me
Your Ex-Lover Is Dead	Set Yourself On Fire	1	Your Ex-Lover Is Dead
